1111111111
10000010C1
1000001101
1000000001
100P000001
1011111111
1000100C01
100000E001
1111111111