11111111111111111111
1P00000000000000C001
110110010C0100010001
10001001111100010001
10C01E00000000000001
10001110011111111111
10000000000000000001
10011111111111111111
10000000000000000001
11111111111111111111